20
20
9
14
FFFFFFFFFFFFFFF+++++
FFFFFFFFFFFFFF++++++
FFFFFFFFFFFFF+++++++
FFFFFFFFFFF+++++RRRR
FFFFFFFFF++++RRRR+++
FFFFFFF++++RRR++++++
FFFFFFF+++RR++++++++
FFFFFFF++RR+++++++++
FFFF+++++R++++++++++
+++++++++R++++++++++
RRRR++RRRR++++++++++
+++RRRR++R++++++++++
+++++++++R++++FFFFFF
+++++++++RR+FFFFFFFF
++++++++++R+FFFFFFFF
++++++++++R++FFFFFFF
++++++++++R+++++FFFF
++++++++++RR++++++++
+++++++++++R++++++++
+++++++++++R++++++++
