30
15
8
5
FFFFFFFFFFFF++++++++++++++++++
FFFFFF++++++++++++++++++++++++
FFFF++++++++++++++++++++++++++
FF++++++++++++++++++++++++++++
++++++++++++++++++++++RRRRR+++
++++++++++++++++++++RRR+++RR++
++++++++++++++++++++R++++++RR+
+++++RRRRRRRR++++RRRR+++++++R+
RRRRRR++++++RRRRRR++R+++++++R+
++++++++++++++++++++R++++++RR+
++++++++++++++++++++RRR++++R++
FFFFF+++++++++++++++++RRRRRR++
FFFFFFFFFFFFFFF+++++++++++++++
FFFFFFFFFFFFFFFF++++++++++++++
FFFFFFFFFFFFFFFFFFFF++++++++++
