25
25
12
6
+++++++++++++++++++++++++
+++++++++++++++++++++++++
+++++++++++++++++++++++++
++++++++++++++++++RRRR+++
RRRRR++++++++++RRRR++RRRR
++++RRRR+++RRRRR+++++++++
+++++++RRRRR+++++++++++++
++++++++++++++++++FFFF+++
+++FFFF++++++++++FFFFF+++
++++FFF++++++++++++FFFF++
+++++FFF++++FFF++++++++++
+++++FFF++++FFFFF++++++++
+++FFFFFF++FFFF+++++++FFF
++++FFFF+++++++++++++FFFF
+++++++++++++++++++++++FF
+++++++++++++++++++WWW+++
WWWWWWWW++++++++WWWWWWWWW
WWWWWWWWWWW+++++WWWWWWWWW
WWWWWWWWWWWW+++++++WWWWWW
+++++WWWWWWW++++++++++WWW
+++++++++++++++++++++++++
+++++++++++++++++++++++++
+++++++++++++++++++++++++
+++++++++++++++++++++++++
+++++++++++++++++++++++++
